beauftragen A. | mit D. 	поручать кому-л. | что-л.
beitragen zu D. 	способствовать чему-л., вносить вклад во что-л.
taugen zu D. 	годиться на что-л.
erkennen A. | an D. 	узнать, опознать кого-л., что-л. | по чему-л.
beitreten D. 	вступать во что-л.
schießen auf A. / nach D. 	стрелять в кого-л., по кому-л.
kämpfen gegen A. 	бороться с кем/чем-л., против кого/чего-л.
schuld sein an D. 	быть виноватым в чём-л.
bezeichnen als N. 	наз(ы)вать, именовать, обозначить кем-л., чем-л.
aufpassen auf A. 	следить, присматривать, наблюдать за чем-л.
glauben an A. 	верить во что-л.
staunen über A 	удивляться чему-л.
überlegen sein an D. 	превосходить в чём-л.
verfallen D. 	быть обреченным на что-л.
nagen an D. 	грызть что-л.
vorbeifahren an D. 	проезжать мимо чего-л.
freuen sich über A. 	радоваться чему-л. (свершившемуся)
entscheiden sich für A. 	решиться на что-л.
arbeiten als N. 	работать кем-л., в качестве/должности кого-л.
brauchen A. (bedürfen G.) 	нуждаться в чём-л.
abhängen von D. (ankommen auf A.) 	зависеть от чего-л., кого-л.
siegen über A. 	победить кого/что-л., выиграть у кого-л.
schimpfen auf/über A. 	ругать, бранить кого-л.