beziehen sich auf 	ссылаться на что-л., затрагивать что-л.
denken an 	думать о чём-л., ком-л.
vorbeigehen an 	проходить мимо чего-л.
rächen für 	мстить за что-л.
rächen an	мстить кому-л.
zürnen 	сердиться на кого-л., что-л.
gehören zu 	принадлежать кому-л., (к) чему-л.
schwärmen von 	мечтать о ком-л.
erkundigen sich nach 	наводить справки, осведомляться о ком-л., чём-л.
erkundigen sich bei 	наводить справки, осведомляться у кого-л., где-л.
verspäten sich zu 	опоздать к чему-л., на что-л.
warten auf 	ждать кого-л., чего-л.
teilnehmen an 	принимать участие в чём-л.
halten auf 	придавать значение чему-л.
begegnen 	встречать кого-л., попадаться навстречу кому-л.
entziehen 	отнимать кого-л., что-л. | у кого-л.
einladen zu 	приглашать на что-л.
einladen	приглашать кого-л.
Angst haben vor 	бояться кого-л., чего-л.
entschließen sich zu 	решиться на что-л.
stören 	мешать кому-л., беспокоить кого-л.
entlaufen 	убегать от кого-л., чего-л.
rechnen mit 	считаться с чем-л.; учитывать, принимать во вниманиечто-л.
arbeiten bei 	работать на кого-л., на какую-л. фирму
interessieren sich für 	интересоваться чем-л.
entschuldigen sich für 	извиняться за что-л.
entschuldigen sich bei	извиняться перед кем-л.
