übelnehmen 	обижаться за что-л., на кого-л.
abholen 	заходить за кем-л.
handeln sich um 	говориться, речь идёт о ком-л., чём-л.
verzichten auf 	отказаться от чего-л. ; пожертвовать, поступиться чем-л.
sorgen für 	заботиться о ком-л., чем-л.
bestehen aus 	состоять из чего-л.
flehen um 	умолять о чём-л.
erkranken an 	заболеть чем-л.
danken für 	благодарить за что-л.
danken 	благодарить кого-л.
fliehen vor 	избегать кого-л., убегать/спасаться от кого-л.
amüsieren sich über 	развлекаться чем-л.
beginnen mit 	нач(ин)ать с чего-л., кого-л.
verstoßen gegen 	нарушить что-л., согрешить против чего-л.
entkommen 	избегнуть чего-л., миновать что-л.
erinnern sich an 	вспоминать о ком-л., чём-л.
trinken auf 	(вы)пить за что-л., кого-л.
bewahren vor 	(со)хранить, (у)беречь от чего-л.
bewahren	(со)хранить, (у)беречь что-л.
ansprechen um 	просить о чём-л.
beteiligen sich an 	участвовать в чём-л.
gratulieren zu 	поздравлять кого-л. с чем-л.
nachgehen 	идти следом за кем-л., чем-л.
zweifeln an 	сомневаться в чём-л., подвергать сомнению что-л.
zustimmen 	соглашаться с кем-л., чем-л.
